А : й
Б : Ю
В : Ч
Г : Э
Д : Л
Е : Ж
Ё : ь
Ж : К
З : Б
И : А
Й : ц
К : Ф
Л : Х
М : п
Н : и
О : б
П : В
Р : е
С : ю
Т : ш
У : Ё
Ф : Я
Х : Е
Ц : ч
Ч : Ш
Ш : а
Щ : Н
Ъ :  
Ы : в
Ь : г
Э : к
Ю : Д
Я : Ы
а : ф
б : л
в : Щ
г : у
д : с
е : И
ё : щ
ж : н
з : о
и : ж
й : Й
к : м
л : з
м : З
н : д
о : р
п : ы
р : Ь
с : С
т : Р
у : т
ф : П
х : Г
ц : ъ
ч : х
ш : Ъ
щ : ё
ъ : э
ы : О
ь : М
э : У
ю : Ц
я : Т
  : я
